I,0,3,0,0,0,0,1,0,0,0,0,3
I,0,0,0,2,1,0,1,0,0,0,0,3
I,0,1,1,1,1,0,1,0,0,0,0,4
I,0,2,0,0,2,0,1,0,0,0,0,4
I,0,0,4,0,0,1,1,0,0,0,0,4
I,0,1,2,1,1,0,1,0,0,0,0,5
I,0,2,2,0,1,0,1,0,0,0,0,5
I,3,1,0,0,1,0,1,0,0,0,0,5
I,1,0,0,0,2,0,0,1,0,0,0,3
I,0,0,0,0,3,0,0,1,0,0,0,3
I,1,0,1,1,1,0,0,1,0,0,0,4
I,0,0,2,0,2,0,0,1,0,0,0,4
I,0,0,0,4,0,1,0,1,0,0,0,4
I,1,0,1,2,1,0,0,1,0,0,0,5
I,1,0,2,2,0,0,0,1,0,0,0,5
I,0,1,3,1,0,0,0,1,0,0,0,5
I,2,1,0,0,0,0,0,0,1,0,0,3
I,0,0,0,3,0,0,0,0,1,0,0,3
I,1,1,0,1,1,0,0,0,1,0,0,4
I,0,2,0,2,0,0,0,0,1,0,0,4
I,0,0,0,0,4,1,0,0,1,0,0,4
I,1,1,0,1,2,0,0,0,1,0,0,5
I,0,1,0,2,2,0,0,0,1,0,0,5
I,1,3,1,0,0,0,0,0,1,0,0,5
I,0,2,1,0,0,0,0,0,0,1,0,3
I,3,0,0,0,0,0,0,0,0,1,0,3
I,1,1,1,0,1,0,0,0,0,1,0,4
I,2,0,0,2,0,0,0,0,0,1,0,4
I,4,0,0,0,0,1,0,0,0,1,0,4
I,2,1,1,0,1,0,0,0,0,1,0,5
I,2,0,1,0,2,0,0,0,0,1,0,5
I,1,0,0,1,3,0,0,0,0,1,0,5
I,0,0,2,1,0,0,0,0,0,0,1,3
I,0,0,3,0,0,0,0,0,0,0,1,3
I,1,1,1,1,0,0,0,0,0,0,1,4
I,2,0,2,0,0,0,0,0,0,0,1,4
I,0,4,0,0,0,1,0,0,0,0,1,4
I,1,2,1,1,0,0,0,0,0,0,1,5
I,2,2,0,1,0,0,0,0,0,0,1,5
I,0,0,1,3,1,0,0,0,0,0,1,5
